80008000
80008040
80008080
800080c0
80008100
80008140
80008180
800081c0
80008200
80008240
80008280
800082c0
80008300
80008340
80008380
800083c0
80008400
80008440
80008480
800084c0
80008500
80008540
80008580
800085c0
80008600
80008640
80008680
800086c0
80008700
80008740
80008780
800087c0
80008800
80008840
80008880
800088c0
80008900
80008940
80008980
800089c0
80008a00
80008a40
80008a80
80008ac0
80008b00
80008b40
80008b80
80008bc0
80008c00
80008c40
80008c80
80008cc0
80008d00
80008d40
80008d80
80008dc0
80008e00
80008e40
80008e80
80008ec0
80008f00
80008f40
80008f80
80008fc0
80009000
80009040
80009080
800090c0
80009100
80009140
80009180
800091c0
80009200
80009240
80009280
800092c0
80009300
80009340
80009380
800093c0
80009400
80009440
80009480
800094c0
80009500
80009540
80009580
800095c0
80009600
80009640
80009680
800096c0
80009700
80009740
80009780
800097c0
80009800
80009840
80009880
800098c0
80009900
80009940
80009980
800099c0
80009a00
80009a40
80009a80
80009ac0
80009b00
80009b40
80009b80
80009bc0
80009c00
80009c40
80009c80
80009cc0
80009d00
80009d40
80009d80
80009dc0
80009e00
80009e40
80009e80
80009ec0
80009f00
80009f40
80009f80
80009fc0
8000a000
8000a040
8000a080
8000a0c0
8000a100
8000a140
8000a180
8000a1c0
8000a200
8000a240
8000a280
8000a2c0
8000a300
8000a340
8000a380
8000a3c0
8000a400
8000a440
8000a480
8000a4c0
8000a500
8000a540
8000a580
8000a5c0
8000a600
8000a640
8000a680
8000a6c0
8000a700
8000a740
8000a780
8000a7c0
8000b000
8000b040
8000b080
8000b0c0
8000b100
8000b140
8000b180
8000b1c0
8000b200
8000b240
8000b280
8000b2c0
8000b300
8000b340
8000b380
8000b3c0
8000c000
